R 800 600
NO ./imgs/stone_texture_n.xpm
SO ./imgs/stone_texture_s.xpm
WE ./imgs/stone_texture_w.xpm
EA ./imgs/stone_texture_e.xpm

S ./imgs/sprite.xpm
F 220,100,0
C 225,30,0


		11111111111111111111111111111
		10000000001100000000000011111
		10110000011100000020000N11111
10010000000000000000000011111
11111111101100000111000000111
10000000001100000111011111111
11110111111111011100000010001
11110111111111011101010010001
11000002110101011100000010001
10002000000000001100000010001
10000000000000001101010010001
11000000000001011111011110001
11110111111101011101111010001
11111111111111111111111111111
